а: and
авто: car
автобус: bus
але: but
ало: hello
англійською: in English
англійцем: by an Englishman
англієць: Englishman
англії: of England
артист/художник: artist/painter
б: would
б'є: hits
бабусею: with a grandmother
бабуся: grandmother
багато: a lot, many, much
багатою: with a rich one
багатьма: with many
банан: banana
бананів: of bananas
бартек: Bartek
баскетбол: basketball
батько: father
батьком: with a father
батькі: parents
бачимо: we see
бачимось: we see each other
бачити: to see
бачить: he/she sees
бачиш: you see
бачу: I see
без: without
безпеки: of security
березень: March
бесіда/розмова: conversation/talk
бесіду: conversation (accusative)
би: would
близько: near, close
блищати: to shine
блищать: they shine
богом: with God
болить: it hurts
болять: they hurt
боліти: to hurt
боявся: was afraid
брат: brother
брата: of the brother
братам: to the brothers
братами: with brothers
братом: with a brother
братів: of brothers
бридкий/поганий: ugly/bad
бридкі: ugly (plural)
був: was (masculine)
був/була: was (masculine/feminine)
буде: will be
будемо: we will be
будете: you (plural) will be
будеш: you (singular) will be
буду: I will be
будуть: they will be
будує: builds
була: was (feminine)
були: were
було: was (neuter)
бути: to be
бібліотека: library
бібліотеки: of the library
бібліотеці: in the library
біг: run
бігати: to run
бігають: they run
бігає: he/she runs
біла: white (feminine)
білий: white (masculine)
білу: white (accusative)
більше: more
більшу: bigger (accusative)
біля: near, by
білі: white (plural)
в: in, at
важка: heavy (feminine)
важкий: heavy (masculine)
важкі: heavy (plural)
важлива: important (feminine)
важливий: important (masculine)
варити: to cook
вариться: is being cooked
вас: you (plural)
ваша: your (feminine)
ввечері: in the evening
вдома: at home
веде: leads
ведуть: they lead
везе: drives
велика: big (feminine)
велике: big (neuter)
велику: big (accusative)
велосипед: bicycle
велосипеди: bicycles
велосипедів: of bicycles
вересень: September
веселий: cheerful
весело: cheerfully
весна: spring
вести: to lead
вечерю: dinner (accusative)
вечеря: dinner
вечері: in the evening
вечір: evening
вже: already
взимку: in winter
взуття: footwear, shoes
ви: you (plural)
вибач: sorry, excuse me
вигляд: appearance, form
виделка: fork
виделки: of the fork
виделкою: with a fork
вина: of wine
вино: wine
виноград: grapes
винограднику: in the vineyard
висить: hangs
висока: tall (feminine)
високий: tall (masculine)
висіти: to hang
вихідний: weekend
вишня: cherry
вище: higher, taller
вище/більш: higher/more
влада: government, power
влітку: in summer
вовк: wolf
вовкові: to the wolf
вогні: lights
вода: water
води: of water
водою: with water
воду: water (accusative)
волос: hair (single)
волосся: hair (plural)
вона: she
вони: they
воно: it
восени: in autumn
восьмий: eighth
восьмій: at eight (o'clock)
вправо: to the right
вранці: in the morning
все: everything
всесвіт: universe
всесвіті: in the universe
встати: to get up
встає: gets up
втомлений: tired
втікав: ran away
втікати: to run away
вулиця: street
вулиці: on the street
вухо: ear
вухом: with an ear
вчимось: we learn
вчимося: we learn
вчителем: with a teacher
вчитель: teacher (male)
вчителька: teacher (female)
вчителькою: with a female teacher
вчитесь: you learn
вчитися: to learn
вчиться: learns
вчора: yesterday
вівторок: Tuesday
від: from
відати: to know
відкрита: open (feminine)
відкрите: open (neuter)
відкритий: open (masculine)
відпочинку: of rest
відпустку: vacation (accusative)
відчувати: to feel
відчуває: feels
відчуваємо: we feel
вікна: windows
вікно: window
віку: of age
він: he
він/вона/воно: he/she/it
вісім: eight
вісімдесят: eighty
вісімнадцять: eighteen
вісімсот: eight hundred
вітер: wind
гарячий: hot
гладка: smooth
гнів: anger
гнівний: angry
гнівно: angrily
говорив: spoke
говоримо: we speak
говорити: to speak
говорить: speaks
говориш: you speak
говорю: I speak
година: hour
годинник: clock
годинників: of clocks
годину: hour (accusative)
годині: at (o'clock)
голова: head
голові: on the head
гондурасу: of Honduras
гора: mountain
горами: with mountains
гордий: proud
гордо: proudly
горщик: pot
горщику: in the pot
горілки: of vodka
гострий: sharp
готель: hotel
готелю: of the hotel
готовий: ready
готувати: to cook, to prepare
готує: cooks, prepares
готуємо: we cook, we prepare
гра: game
грати: to play
граю: I play
грає: plays
граємо: we play
грудень: December
грудні: in December
групою: with a group
грушка: pear
грушки: pears
гріти: to heat
гріє: heats
гітарі: on the guitar
давай: let's, come on
давати: to give
давно: long ago
дай: give
дайте: give (plural)
далеко: far
дам: I will give
дар: gift
даси: you will give
дасте: you (plural) will give
дасть: will give
дати: to give
дають: they give
дає: gives
даємо: we give
даєш: you give
два: two
двадцять: twenty
дванадцять: twelve
дванадцятій: at twelve (o'clock)
дверей: of the doors
двері: door
двохсотий: two hundredth
дві: two (feminine)
двісті: two hundred
де: where
девяносто: ninety
девятий: ninth
девятнадцять: nineteen
девятсот: nine hundred
девятсотий: nine hundredth
девять: nine
девятій: at nine (o'clock)
день: day
дерева: trees
деревами: with trees
дерево: tree
дереві: on the tree
держава: state
держави: of the state
державою: with the state
десята: tenth (feminine)
десять: ten
десятій: at ten (o'clock)
дзеркало: mirror
дзеркалом: with a mirror
дивимось: we watch
дивитись: to watch
дивиться: watches
дивишся: you watch
дивляться: they watch
диня: melon
дитина: child
дитя: child
для: for
днем: by day
днів: of days
до: to, until
добра: good (feminine)
добре: good, well
добрий: good (masculine)
доброго: of good
добрі: good (plural)
довга: long (feminine)
довге: long (neuter)
довгий: long (masculine)
довгу: long (accusative)
додається: is added
додому: home (to home)
дозріла: ripe (feminine)
дозрілий: ripe (masculine)
документи: documents
долар: dollar
долари: dollars
доларів: of dollars
долина: valley
долину: valley (accusative)
домом: with a house
домі: in the house
домів: of houses
дорога: road
дорога/шлях: road/way
дорогий: expensive, dear
дорогоцінний: precious
дорогу: road (accusative)
дочка: daughter
дочкою: with a daughter
дощ: rain
дощу: of rain
друг: friend
друга: of a friend, second
другий: second
другом: with a friend
другій: at second (o'clock)
друзями: with friends
друзі: friends
друзів: of friends
дуб: oak
дуба: of the oak
дуже: very
думає: thinks
дурний: stupid
дурниць: of nonsense
дух: spirit
душу: soul (accusative)
душі: of the soul
дує: blows
дякую: thank you
дівчина: girl
дід: grandfather
дідом: with a grandfather
дім: house
діти: children
дітьми: with children
емоція: emotion
енергії: of energy
ж: but, and
жаба: frog
жабам: to the frogs
жабі: to the frog
жаль: pity
жалісно: sadly
живе: lives
живемо: we live
жовте: yellow (neuter)
жовтень: October
жовтий: yellow (masculine)
жін: women
жінка: woman
жінки: of the woman, women
жінкою: with a woman
жінку: woman (accusative)
жінок: of women
жіночий: female
жінці: to the woman
з: with, from
з/зі: with, from
за: for, behind
завдання: task, assignment
завдань: of tasks
завжди: always
завтра: tomorrow
заздрісно: enviously
заздрість: envy
займаються: they are engaged in
закриті: closed
закінчується: ends
запах: smell
запис: note
записник: notebook
записник/зошит: notebook
записів: of notes
запізно: too late
зараз: now
заходить: sets (sun)
заході: in the west
захід: west
західний: western
звуть: they call
звір: beast, animal
звіром: with a beast
звіру: to the beast
здоров'я: health
здорове: healthy (neuter)
здоровий: healthy (masculine)
здоровий/привіт: healthy/hello
зелена: green (feminine)
зелене: green (neuter)
зелений: green (masculine)
зелену: green (accusative)
зелені: green (plural)
землю: earth (accusative)
земля: earth, land
землі: of the earth
зима: winter
зла: evil (feminine)
злий: evil (masculine)
злі: evil (plural)
змінювати: to change
змінюватися: to change
змінюються: they change
змінюється: it changes
знайти: to find
знати: to know
знаю: I know
знають: they know
знає: knows
знижку: discount (accusative)
зрозумів: understood
зсередини: from inside
зєднати: to connect
зєднує: connects
зі: with
зірка: star
зірки: stars
зірок: of stars
йде: goes
йдемо: we go
йдете: you go
йдеш: you go
йди: go
йду: I go
йдуть: they go
йдіть: go (plural)
його: his, him
йому: to him
йшла: she went
йшли: they went
йшло: it went
йшов: he went
кава: coffee
кави: of coffee
каже: says
каже/показує: says/shows
казати/показувати: to say/to show
камені: stones
камінь: stone
картини: pictures
картину: picture (accusative)
каштанове: brown (neuter)
каштановий: brown (masculine)
квадрат: square
квадрата: of the square
квіт: flower
квітень: April
квіти: flowers
ким: with whom
кисла: sour (feminine)
кислий: sour (masculine)
книжка: book
книжки: books
книжку: book (accusative)
ковбаса: sausage
ковбаси: of sausage
кого: whom
кожен: each, every
кожною: with each
колесо: wheel
колесо/велосипед: wheel/bicycle
коли: when
коло: near
кольорів: of colors
колір: color
комп'ютер: computer
комп'ютери: computers
комп'ютерів: of computers
комп\'ютер: computer
компас: compass
комплексна: complex (feminine)
кому: to whom
комфортний: comfortable
комфортні: comfortable (plural)
консерва: canned food
контролює: controls
коню: to the horse
коротка: short (feminine)
короткі: short (plural)
кості: bones
коти: cats
котові: to the cat
котів: of cats
красива: beautiful (feminine)
красиве: beautiful (neuter)
красивий: beautiful (masculine)
красиво: beautifully
красиві: beautiful (plural)
краще: better
краєвид: landscape
краї: countries
куди: where (to)
культурою: with culture
купець/покупець: merchant/customer
купила: she bought
купити: to buy
куплю: I will buy
купують: they buy
купує: buys
купуємо: we buy
кусень: piece
кусень/шматок: piece/slice
кухар: cook
кухарем: with a cook
кухня: kitchen
кухні: in the kitchen
кімната: room
кімнати: of the room
кімнаті: in the room
кінотеатру: of the cinema
кінь: horse
кістки: bones
кістку: bone (accusative)
кіт: cat
лампа: lamp
ласкаво: welcome
лежати: to lie
лежать: they lie
лежить: lies
лимон: lemon
липень: July
лист: leaf, letter
листи: letters
листопад: November
листя: leaves
ложка: spoon
любимо: we love
любити: to love
любить: loves
любиш: you love
люблю: I love
люблять: they love
любов: love
любові: of love
людей: of people
люди: people
людина: person
людям: to people
лютий: February
лютому: in February
лягаєся: lies down
ліво: left
ліворуч: to the left
ліжко: bed
ліжком: with a bed
лікар: doctor
лікарем: with a doctor
лінивий: lazy
ліниві: lazy (plural)
лінія: line
лінії: of the line
ліс: forest
літа: years
літо: summer
м'яке: soft
м'ясо: meat
мав: had
магазин: shop
магазину: of the shop
магазині: in the shop
майдану: of the square
майдані: in the square
мала: had (feminine), small (feminine)
маленькою: with a small one
малий: small
малювати: to draw
малюю: I draw
малює: draws
малюємо: we draw
мапа/карта: map
мапі: on the map
маси: of mass
масла: of butter
масло: butter
маслом: with butter
математика: mathematics
мати: mother, to have
маткою: with a mother
маю: I have
мають: they have
має: has
маєш: you have
медведеві: to the bear
медведям: to the bears
медвідь: bear
мене: me
менше: less
мені: to me
метод: method
ми: we
милий: dear, nice
милі: dear, nice (plural)
миска: bowl
мисці: in the bowl
миша: mouse
миші: mice
млинець: pancake
мова: language
мови: of the language
мовою: with the language
мовчати: to be silent
мовчить: is silent
може: can, maybe
можете: you can
можливо: maybe
можна: it is possible
мозок: brain
мокра: wet (feminine)
мокрий: wet (masculine)
молода: young (feminine)
молодий: young (masculine)
молоді: young (plural)
молока: of milk
молоко: milk
море: sea
мороз: frost
морозу: of frost
моста: of the bridge
мості: on the bridge
моя: my (feminine)
моє: my (neuter)
моєю: with my (feminine)
моєї: of my (feminine)
мої: my (plural)
моїм: with my
мудра: wise (feminine)
мудрий: wise (masculine)
мудрі: wise (plural)
музика: music
музику: music (accusative)
між: between
мій: my (masculine)
міст: bridge
міста: of the city
містах: in the cities
місто: city
місті: in the city
місяцем: with the month
місяць: month, moon
на: on, at
навесні: in spring
над: above
найближчий: nearest
наліво: to the left
нами: with us
наповнена: filled
наповнилося: became filled
направо: to the right
народ: people, nation
народів: of nations
нас: us
нашими: with our
не: not
небо: sky
небі: in the sky
недобре: not good
неділя: Sunday
нема: there is no
несе: carries
нести: to carry
несуть: they carry
низька: low (feminine)
низький: low (masculine)
нова: new (feminine)
нове: new (neuter)
новий: new (masculine)
нову: new (accusative)
нові: new (plural)
нога: leg, foot
ноги: legs, feet
ногу: leg (accusative)
ножем: with a knife
ножі: knives
носив: wore, carried
носити: to wear, to carry
носить: wears, carries
ночі: of the night
ношу: I wear, I carry
нудна: boring
нуль: zero
нього: him
ні: no
ніж: knife
німець: German
німецькою: in German
німеччині: in Germany
ніс: nose
ніч: night
нічого: nothing
о: about
обережний: careful
обличчя: face
обмежена: limited
обрис: outline
обід: lunch
один: one
одинадцять: eleven
одинадцятій: at eleven (o'clock)
одиницею: with a unit
одна: one (feminine)
одне: one (neuter)
одним: with one
одну: one (accusative)
одяг: clothes
одягав: wore
одягати: to wear
одягає: wears
одягу: of clothes
озера: of the lake
означає: means
око: eye
онук: grandson
онуком: with a grandson
онучка: granddaughter
онучкою: with a granddaughter
основні: basic
останній: last
осінь: autumn
отець/батько: father
офісі: in the office
очах: in the eyes
очі: eyes
п'ятницею: with Friday
п'ятницю: Friday (accusative)
п'ять: five
п'є: drinks
п'ємо: we drink
п'єш: you drink
п\'ять: five
падати: to fall
падаюче: falling
падає: falls
палець: finger
пальто: coat
папері: on paper
папір: paper
парк: park
пахне: smells
пахнути: to smell
певен: sure
пельмень: dumpling
перед: before, in front of
переляканий: frightened
перепрошую: excuse me
перець: pepper
перо: pen, feather
пером: with a pen
перцю: of pepper
перший: first
першим: with the first
першій: at one (o'clock)
пес: dog
пива: of beer
пиво: beer
писар: scribe
писати: to write
питати: to ask
питаю: I ask
питає: asks
пити: to drink
пише: writes
пишемо: we write
пишу: I write
плавання: swimming
плавати: to swim
плаваємо: we swim
план: plan
плащ: raincoat
площа/майдан: square
площі: on the square
площі/майдану: of the square
пляшка: bottle
пляшки: of the bottle
пляшку: bottle (accusative)
пляшок: of bottles
по: along
побачиш: you will see
повернення: return
повна: full (feminine)
повний: full (masculine)
повтори: repeat
повітря: air
поганий: bad
погода: weather
подорожувати: to travel
подорожує: travels
подушка: pillow
подібне: similar (neuter)
подібний: similar (masculine)
показати: to show
показувати: to show
показує: shows
поле: field
полиця: shelf
польща: Poland
польщі: in Poland
поляк: Pole
поляком: with a Pole
полями: with fields
полі: in the field
полів: of fields
поліцейський: policeman
помагали: they helped
помагати: to help
помагає: helps
помагаємо: we help
помаранча/апельсин: orange
помаранчевий: orange (adjective)
помаранчеву: orange (accusative)
помаранчі: oranges
помаранчів: of oranges
помогла: she helped
понеділка: of Monday
понеділок: Monday
порожня: empty
портрет: portrait
посередині: in the middle
потребувати: to need
потребує: needs
потім: then
походження: origin
почув: heard
поїзд: train
поїздів: of trains
правду: truth (accusative)
право: right
працювали: they worked
працювати: to work
працюю/працюємо: I work/we work
працює: works
предмет: subject, object
привіт: hello
привітай: greet
привітання: greeting
принесе: will bring
природна: natural
приємне: pleasant
про: about
пробувати: to try
пробує: tries
прогулянку: a walk (accusative)
продавати: to sell
продавець: seller
продавцеві: to the seller
продає: sells
просимо: we ask, please
проспект: avenue
простий: simple
просто: simply
прошу: please
прямо: straight
псу: to the dog
птах: bird
птахам: to the birds
птахові: to the bird
пункт: point
пята: heel
пятдесят: fifty
пятий: fifth
пятнадцять: fifteen
пятниця: Friday
пятсот: five hundred
пять: five
пятій: at five (o'clock)
пє: drinks
південний: southern
південної: of the south
південні: southern (plural)
південь: south
півдні: in the south
півночі: in the north
північ: north
північна: northern (feminine)
північний: northern (masculine)
північно-західний: northwestern
під: under
підлозі: on the floor
підписаний: signed
піжама: pajama
після: after
пісні: songs
піцу: pizza (accusative)
пішли: they went
пішов: he went
р: r
радіо: radio
радісний: joyful
радісно: joyfully
радість: joy
рази: times
ранку: of the morning
ранок: morning
реакція: reaction
регіон: region
ресторан: restaurant
речей: of things
речі: things
риба: fish
рибу: fish (accusative)
рибі: to the fish
робив: did, made
робили: they did, they made
робити: to do, to make
робить: does, makes
роботи: of work
роботу: work (accusative)
робочий: working
робітник: worker
родина: family
родини: of the family
родиною: with the family
роза: rose
розбите: broken (neuter)
розбитий/зламаний: broken
розумію: I understand
романи: novels
росте: grows
рости: to grow
ростуть: they grow
російської: of Russian
російську: Russian (accusative)
росіянин: Russian (person)
росіянином: with a Russian
росії: of Russia
рубль: ruble
рублів: of rubles
рука: hand, arm
рукавичка: glove
рукавички: gloves
рукавичок: of gloves
руки: hands, arms
руку: hand, arm (accusative)
рівна: equal (feminine)
рівний: equal (masculine)
рід: kind, family
ріже: cuts
різати: to cut
рік: year
ріка: river
ріки: of the river
річ: thing
річку: river (accusative)
річці: in the river
с: with
сам: alone, self
свою: my/his/her/its (accusative)
своєю: with my/his/her/its
свіжа: fresh (feminine)
свіжий: fresh (masculine)
свій: my/his/her/its own
світити: to shine
світить: shines
світле: light (adjective, neuter)
світлий: light (adjective, masculine)
світло: light (noun)
світлофор: traffic light
сезон: season
сезони: seasons
сезоном: with the season
секунд: of seconds
секунда: second
семи: of seven
середа: Wednesday
середній: middle
середу: Wednesday (accusative)
серпень: August
серпні: in August
серце: heart
серці: in the heart
серіал: series
сестра: sister
сестрою: with a sister
сестру: sister (accusative)
сивий: grey
сидить: sits
сидіння: seat
сидіти: to sit
сильна: strong (feminine)
сильний: strong (masculine)
сильно: strongly
символом: with a symbol
син: son
сином: with a son
синю: blue (accusative)
синє: blue (neuter)
сині: blue (plural)
синій: blue (masculine)
сир: cheese
сиру: of cheese
ситуацію: situation (accusative)
складний: difficult, complex
сковорідка: frying pan
сковорідці: in the frying pan
скоро: soon
скривати/ховати: to hide
скриває: hides
скриня: chest, box
скрині: in the chest
скільки: how much, how many
слабкий: weak
слабі: weak (plural)
слив: of plums
слива: plum
сливовицю: plum brandy (accusative)
слов'янином: by a Slav
слов'янською: in Slavic
слов'янську: Slavic (accusative)
слов\'янин: Slav
слова: words
слухати: to listen
слухають: they listen
смачна: tasty (feminine)
смачну: tasty (accusative)
сміливий: brave
сміятися: to laugh
сміється: laughs
сну: of a dream
сніг: snow
снігом: with snow
снігу: of snow
сніданок: breakfast
собак: of dogs
собаки: dogs
собою: with oneself
собі: to oneself
соку: of juice
солодка: sweet (feminine)
солодкий: sweet (masculine)
солодку: sweet (accusative)
солодкі: sweet (plural)
солі: of salt
сон: dream, sleep
сонце: sun
сонць: of suns
сонця: of the sun
сорок: forty
сором: shame
соромливий: shy
соромно: ashamed
сорочка: shirt
сорочку: shirt (accusative)
сотий: hundredth
спати: to sleep
спить: sleeps
спокій: peace
спокійно: calmly
спокійного: of the calm
спокійної: of the calm
спорт: sport
спортом: with sport
спортсменів: of sportsmen
спорту: of sport
спорті: in sport
справи: matters, affairs
співати: to sing
співаю: I sing
співає: sings
срібна: silver (feminine)
стадіон: stadium
стадіоні: at the stadium
стайні: in the stable
станцію: station (accusative)
станція: station
стара: old (feminine)
старий: old (masculine)
стару: old (accusative)
старі: old (plural)
ствердно: affirmatively
сто: hundred
столом: with the table
столу: of the table
столі: on the table
стопа: foot
стопи: of the foot
сторона: side
сторони: of the side
сторону: side (accusative)
стояти: to stand
стоїмо: we stand
стоїть: stands
страва: dish (food)
страву: dish (accusative)
страх: fear
стрий: uncle
стриєм: with an uncle
студентами: with students
стіл: table
стілець: chair
стіна: wall
стіні: on the wall
субота: Saturday
сукню: dress (accusative)
сумку: bag (accusative)
сумний/жалісний: sad
сухо: dry
сході: in the east
схід: east
східна: eastern (feminine)
східний: eastern (masculine)
сьогодні: today
сьома: seventh (feminine)
сьомий: seventh (masculine)
сідає: sits down
сік: juice
сіль: salt
сім: seven
сімдесят: seventy
сімнадцять: seventeen
сімсот: seven hundred
сірий: grey
сірі: grey (plural)
сісти: to sit down
січень: January
січні: in January
та: and, so
так: yes
так/отже: yes/so
також: also
там: there
тамта: that one (feminine)
тамтой: that one (masculine)
танцювати: to dance
танцюю: I dance
тарілка: plate
творчість: creativity
твою: your (accusative)
твоєю: with your
твоїм: with your
твій: your
те: that (neuter)
тебе: you
темна: dark (feminine)
темне: dark (neuter)
темний: dark (masculine)
темні: dark (plural)
теніс: tennis
тепла: warm (feminine)
тепле: warm (neuter)
теплий: warm (masculine)
тепло: warm, warmly
теплі: warm (plural)
терпіти: to suffer, to endure
тече: flows
ти: you (singular)
тиждень: week
тижня: of the week
тижні: in the week
тим: with that
тисяча: thousand
тисячний: thousandth
тисячі: thousands
тиха: quiet (feminine)
тихий: quiet (masculine)
тихі: quiet (plural)
то: then, that is
тобою: with you
тобі: to you
товстий: fat, thick
того: of that
той: that (masculine)
тому: because, to that
торба/сумка: bag
торбі: in the bag
торговище: marketplace
торговищі: at the marketplace
точка: point, dot
трава: grass
травень: May
траву: grass (accusative)
треба: need to
тренувати: to train
тренує: trains
трепет/страх: tremor/fear
третій: third
три: three
тривалість: duration
тривати: to last
триває: lasts
тридцятий: thirtieth
тридцять: thirty
трикутник: triangle
тримати: to hold
тримає: holds
тринадцять: thirteen
триста: three hundred
труси/штани: pants/trousers
ту: that (accusative)
тут: here
туш: mascara, shower
тілесної: of the body
тіло: body
тільки: only
тілі: in the body
тітка: aunt
тіткою: with an aunt
у: in, at
удома: at home
улюблений: favorite
учень: student
учнем: with a student
учням: to the students
факти: facts
фляжка/пляшка: bottle
фляжки/пляшки: bottles
фонтан: fountain
форма: shape, form
форма/вигляд: shape/form
форми: of the shape
форму: shape (accusative)
франка: of the franc
футбол: football
футболка: t-shirt
футболку: t-shirt (accusative)
фігура: figure
фігури: figures
фільм: film, movie
хвилин: of minutes
хвилина: minute
хлопець: boy
хлопці: boys
хлопців: of boys
хліб: bread
хліба: of bread
хмар: of clouds
хмара: cloud
хмари: clouds
хмарно: cloudy
хокей: hockey
холодна: cold (feminine)
холодне: cold (neuter)
холодний: cold (masculine)
холодно: cold (adverb)
хорват: Croat
хорватка: Croatian (female)
хорваткою: with a Croatian female
хорватською: in Croatian
хотіти: to want
хоче: wants
хочемо: we want
хочеш: you want
хочу: I want
хто: who
худа: thin (feminine)
худий: thin (masculine)
цвісти: to bloom
цвіте: blooms
цвітуть: they bloom
це: this is, it is
цей: this (masculine)
центру: of the center
центрі: in the center
церква: church
цим: with this
цих: of these
цукор: sugar
цукру: of sugar
ця: this (feminine)
ці: these
цікава: interesting (feminine)
цікавий: interesting (masculine)
ціна: price
ціну: price (accusative)
ч: h (hour)
ч/с: h/s
чай: tea
час: time, hour
часом: sometimes
часто: often
часу: of time
чашка: cup
чашки: of the cup
чашку: cup (accusative)
чаю: of tea
чек: check, receipt
червень: June
червона: red (feminine)
червоне: red (neuter)
червоний: red (masculine)
червоні: red (plural)
через: through, across
четвер: Thursday
четвертий: fourth
четвертій: at four (o'clock)
чи: if, whether
чиста: clean (feminine)
чисте: clean (neuter)
чистий: clean (masculine)
читати: to read
читаю: I read
читає: reads
читаєш: you read
чого: of what
чол: male
чоловік: man, husband
чоловіком: with a man
чоловіків: of men
чоловічий: male
чорна: black (feminine)
чорне: black (neuter)
чорний: black (masculine)
чорні: black (plural)
чотири: four
чотириста: four hundred
чотирнадцять: fourteen
чути: to hear
чуюся: I feel
чує: hears
шапка: hat
шапки: of the hat
шапку: hat (accusative)
шарф: scarf
шафа: wardrobe
шахи: chess
швидкий: fast, quick
швидко: fast, quickly
швидкість: speed
широка: wide (feminine)
широке: wide (neuter)
шити: to sew
шию: I sew
шиє: sews
шиєш: you sew
шкарпетка: sock
шкарпетки: socks
шкода: pity, damage
школа: school
шкіра: skin, leather
шлунок: stomach
шлях: way, path
шостий: sixth
шостій: at six (o'clock)
шофер/водій: driver
штани: trousers
шістдесят: sixty
шістнадцять: sixteen
шістсот: six hundred
шістсотий: six hundredth
шість: six
ще: still, yet
щира: sincere (feminine)
щирий: sincere (masculine)
що: what, that
щоденник: diary
я: I
яблуко: apple
ягода: berry
ягоди: berries
яйце: egg
яйця: eggs
як: how, as
якби: if
є: is, are
і: and
ім'я: name
ім\'я: name
імені: of the name
інженер: engineer
інженером: with an engineer
їде: goes (by transport)
їду: I go (by transport)
їдуть: they go (by transport)
їжа: food
їжею: with food
їжу: food (accusative)
їжі: of food
їм: I eat
їмо: we eat
їси: you eat
їсти: to eat
їсть: eats
їх: them, their
їхати: to go (by transport)
їхнього: their
її: her