а: and, but
авгꙋстъ: August
авгꙋстꙋ: in August
азъ: I
алє: but, however
аньглийськомъ: in English
аньгличаниномъ: by an Englishman
аньгличанинъ: Englishman
аньглиѥ: England
апрїль: April
артистъ: artist
аѵто: car
аѵтобꙋсъ: bus
бабка: grandmother
бабкоѭ: with grandmother
банановъ: banana (adjective)
бананъ: banana
бартєкъ: Bartek (a name)
баскетъболъ: basketball
библиотека: library
библиотекꙑ: of the library
библиотецѣ: in the library
биѥтъ: he/she/it hits
благодаримъ: we thank
близъко: near, close
близъкъи: close, near
блѣскати: to shine
блѣскаѭтъ: they shine
блѭдо: dish, plate
богатоѭ: with a rich one
богомь: with God
болитъ: it hurts
болѣти: to be sick, to hurt
болѧтъ: they hurt
боꙗлъ: was afraid
брата: of the brother
братамъ: to the brothers
братахъ: about the brothers
братиѭ: with the brother
братомъ: with the brother
братъ: brother
бридъкъ: ugly
бридъкъи: ugly
бридъкє: ugly
бръзина: speed
бързо: fast, quickly
бързъи: fast, quick
бързѫ: fast (accusative)
бєзъ: without
бєзъопacьности: of security
бєсѣда: conversation
бєсѣдѫ: conversation (accusative)
бѣгати: to run
бѣгаѥтъ: he/she/it runs
бѣгаѭтъ: they run
бѣгъ: run, race
бѣла: white (feminine)
бѣлъ: white (masculine)
бѣлє: white (neuter)
бѣлꙋ: white (accusative)
бꙋдємъ: we will be
бꙋдєтъ: he/she/it will be
бꙋдєтє: you (plural) will be
бꙋдєши: you (singular) will be
бꙋдѫ: I will be
бꙋдѫтъ: they will be
бꙋтꙑлък: of bottles
бꙋтꙑлька: bottle
бꙋтꙑлькꙑ: bottles
бꙑ: would be
бꙑла: she was
бꙑли: they were
бꙑло: it was
бꙑлъ: he was
бꙑстро: fast, quickly
бꙑстє: you (plural) were
бꙑти: to be
бꙑхомъ: we would be
бꙑхъ: I would be
бꙑши: you (singular) would be
важьна: important (feminine)
важьнъ: important (masculine)
ваканции: holidays
варити: to cook
варитъ: he/she/it cooks
васъ: you (plural, accusative/genitive)
ваша: your (feminine)
ває: (this word is unclear, could be a typo or a rare form)
видимъ: we see
видитъ: he/she/it sees
видиши: you (singular) see
видѣти: to see
виждѫ: I see
викєндъ: weekend
вилица: fork
вилѥцє: with a fork
вилѥцєѭ: with a fork
вина: of wine
виници: in wine
вино: wine
виноградъ: grapes
виситъ: it hangs
висѣти: to hang
вишьнѧ: cherry
вкꙋсьна: tasty (feminine)
вкꙋсьнъ: tasty (masculine)
вкꙋсьнѫ: tasty (accusative)
влада: ruler, government
власъ: hair
власꙑ: hair (plural)
внꙋкомъ: with a grandson
внꙋкъ: grandson
внꙋчкоѭ: with a granddaughter
внꙋчька: granddaughter
вода: water
водкꙑ: of vodka
водоѭ: with water
водѫ: water (accusative)
водꙑ: of water
вонѧти: to stink
вонѧѥтъ: it stinks
всєгда: always
въ: in, at
възходъ: east
възходъна: eastern (feminine)
възходъно: eastern (neuter)
възходънъ: eastern (masculine)
възходꙋ: to the east
възъдꙋхъ: air
вълкъ: wolf
вълкꙋ: to the wolf
въстанєтъ: he/she/it will get up
въстати: to get up
въсє: everything
въсѧкъи: every
въторои: second
въторъ: second
въторъкъ: Tuesday
въчєра: yesterday
вьсєсвѣтъ: universe
вьсєсвѣтꙋ: to the universe
вєдєтъ: he/she/it leads
вєдѫтъ: they lead
вєлика: big, great (feminine)
вєликъи: big, great
вєликꙋ: big, great (accusative)
вєлосипєдовъ: of bicycles
вєлосипєдъ: bicycle
вєлосипєдꙑ: bicycles
вєсноѭ: in spring
вєсти: to lead
вєсьна: spring
вєсєло: cheerfully
вєсєлъ: cheerful
вєчєромъ: in the evening
вєчєръ: evening
вєчєрѣ: in the evening
вєчєрѭ: dinner (accusative)
вєчєрꙋ: for dinner
вєчєрꙗ: dinner
вѣдѣти: to know
вѣкъ: century, age
вѣсть: news
вѣтръ: wind
вѣщи: things
вѣщии: of things
вѣщь: thing
вꙑ: you (plural)
вꙑсока: high, tall (feminine)
вꙑсокъи: high, tall
вꙑшє: higher
гащє: pants
гдѣ: where
гитарꙋ: guitar (accusative)
глава: head
главѣ: on the head
глаголи: words, verbs
глаголилъ: he spoke
глаголимъ: we speak
глаголити: to speak
глаголиши: you (singular) speak
глаголѭ: I speak
гладка: smooth (feminine)
глѧдаѥмъ: we watch
глѧдаѥтъ: he/she/it watches
глѧдаѭтъ: they watch
глѧдѣти: to watch
глѧдѣши: you (singular) watch
глѧдѣѥмъ: we watch
глꙋпостии: of stupidity
глꙋпъ: stupid
гнѣвъ: anger
гнѣвьно: angrily
гнѣвьнъ: angry
гора: mountain
горами: with mountains
гордо: proudly
гордъ: proud
горѧшти: hot, burning
готови: he/she/it prepares
готовимъ: we prepare
готовити: to prepare
готовъ: ready
града: of the city
градахъ: in the cities
градъ: city, town
градѣ: in the city
градꙋ: to the city
гръньци: pots
гръньць: pot
грѣти: to warm
грѣѥтъ: it warms
грꙋпоѭ: with a group
грꙋшька: pear
грꙋшькꙑ: pears
гєрмании: of Germany
да: yes, and
даваи: give (imperative)
давати: to give
даи: give (imperative)
даитє: give (plural imperative)
далєка: far (feminine)
далєко: far
дамъ: I will give
даръ: gift
даси: you (singular) will give
дати: to give
даѥмъ: we give
даѥтъ: he/she/it gives
даѥши: you (singular) give
даѭтъ: they give
два: two
двєри: doors
двѣ: two (feminine/neuter)
до: to, until
добра: good (feminine)
добри: good (plural)
добрии: good
добро: good
добродошли: welcome
добръ: good (masculine)
добръи: good
додаваѥтъ: he/she/it adds
дозрѣла: ripe (feminine)
дозрѣлъ: ripe (masculine)
докторомъ: with a doctor
докторъ: doctor
докꙋмєнтꙑ: documents
доларовъ: of dollars
доларъ: dollar
доларꙑ: dollars
долина: valley
долинѫ: valley (accusative)
дома: at home
домовъ: of houses
домомъ: with a house
домъ: house
домꙋ: to the house
дорога: road
дорогꙋ: road (accusative)
дошти: to come
дощєриѭ: with a daughter
драга: dear (feminine)
драгоцѣньнъи: precious
дрьжава: state, country
дрьжаваѭ: with a state
дрьжавꙑ: of the state
дрьжати: to hold
дрьжитъ: he/she/it holds
дрєва: trees
дрѣвами: with trees
дрѣво: tree
дрѣвѣ: on the tree
дъва: two
дъвадесѧть: twenty
дъванадесѧтои: twelfth
дъванадесѧть: twelve
дъвєрꙗхъ: in the doors
дъвѣ: two (feminine/neuter)
дъвѣстѣ: two hundred
дъвѣсътънъ: two hundredth
дъждь: rain
дъждьꙋ: to the rain
дълъга: long (feminine)
дълъго: long
дълъгъ: long (masculine)
дълъгє: long (neuter)
дълъгѫ: long (accusative)
дъновъ: of days
дьнь: day
дьньвникъ: diary
дьньмъ: by day
дьнѥвъ: of days
дєбєлъ: thick, fat
дєбєлъи: thick, fat
дєвѧтои: ninth
дєвѧтъ: nine
дєвѧть: nine
дєвѧтьдесѧть: ninety
дєвѧтьнадесѧть: nineteen
дєвѧтьстъ: nine hundred
дєвѧтьсътънъ: nine hundredth
дєкємвриꙋ: in December
дєкємврїи: in December
дєсѧтои: tenth
дєсѧть: ten
дєсѧтьнадесѧть: nineteen (incorrect, should be seventeen)
дѣва: girl
дѣвъка: girl
дѣдомъ: with a grandfather
дѣдъ: grandfather
дѣлали: they did
дѣлалъ: he did
дѣлати: to do, to make
дѣлаѥтъ: he/she/it does
дѣтми: with children
дѣтє: child
дѣтѧ: child
дꙋбъ: oak
дꙋбꙋ: to the oak
дꙋхъ: spirit
дꙋшє: soul
дꙋшѫ: soul (accusative)
дꙋѥтъ: it blows
жаба: frog
жабѣ: to the frog
жалость: sadness, pity
жалостьно: sadly
жалостьнъ: sad
жена: wife, woman
женоѭ: with a wife
женъ: of women
женѣ: to the wife
женѫ: wife (accusative)
женꙑ: of the wife
живєтъ: he/she/it lives
жинємъ: we live
жълто: yellow (neuter)
жълтъ: yellow (masculine)
жєлѫдъкъ: stomach
за: for, behind
зависть: envy
завистьно: envious
завътръкъ: breakfast
завътръкѫ: breakfast (accusative)
завътъра: for breakfast
задании: of the task
заданиѥ: task, exercise
закрьтє: closed
западаѥтъ: it sets (sun)
западъ: west
западънъ: western
западънъи: western
западꙋ: to the west
запахъ: smell, scent
запись: note, record
записьникъ: notebook
записьѥвъ: of notes
звѣзда: star
звѣздъ: of stars
звѣздꙑ: stars
звѣри: animals
звѣромъ: with an animal
звѣрь: animal, beast
здраво: hello, healthily
здравъ: healthy
здравѥ: health
зима: winter
зимоѭ: in winter
зимѣ: in winter
зла: evil (feminine)
злъи: evil
злє: evilly
знамъ: I know
знати: to know
значитъ: it means
знаѥтъ: he/she/it knows
знаѭ: I know
знаѭтъ: they know
зовєши: you (singular) call
зовѫ: I call
зълъ: evil (masculine)
зьрцало: mirror
зьрцаломъ: with a mirror
зєлєна: green (feminine)
зєлєно: green (neuter)
зєлєнъ: green (masculine)
зєлєнъи: green
зєлєнє: green (plural)
зєлєнѫ: green (accusative)
зємли: of the earth
зємлѥ: on the earth
зємлѭ: earth (accusative)
зємлꙗ: earth, land
и: and
игра: game
играти: to play
играѥмъ: we play
играѥтъ: he/she/it plays
играѭ: I play
иди: go (imperative)
идємъ: we go
идєтъ: he/she/it goes
идєтє: you (plural) go
идєши: you (singular) go
идѫтъ: they go
извини: excuse me, sorry
измѣнѧти: to change
измѣнѧѥтъ: it changes
изъ: from
изъвънꙋтра: from inside
или: or
имамъ: I have
имаши: you (singular) have
имаѥтъ: he/she/it has
имаѭтъ: they have
имъ: to them
имєнє: of the name
имѣлъ: he had
имѧ: name
интєрєсьна: interesting (feminine)
интєрєсьнъ: interesting (masculine)
инъжєнѥромъ: by an engineer
инъжєнѥръ: engineer
искрєна: sincere (feminine)
искрєнъ: sincere (masculine)
искрєнъи: sincere
ихъ: their, them
июль: July
июнь: June
кава: coffee
кавꙑ: of coffee
каждъи: each, every
кажєтъ: he/she/it says
казати: to say
како: how
какъ: how
камєни: stones
камєниѭ: with a stone
камєнь: stone
каштанови: brown (plural)
каштаново: brown (neuter)
каштановъ: brown (masculine)
каштановъи: brown
квадрата: of the square
квадратъ: square
кимь: with whom
кина: of the cinema
книга: book
книгѫ: book (accusative)
кого: whom
кожа: skin, leather
колико: how much, how many
коло: around, near
кологовъ: of the colors
колоръ: color
компасъ: compass
комплєксьна: complex (feminine)
компютєр: computer
компютєровъ: of computers
комфортьна: comfortable (feminine)
комфортьнє: comfortably
комꙋ: to whom
консєрва: canned food
контролѥтъ: he/she/it controls
конь: horse
коньчаѥтъ: it ends
конѭ: to the horse
кости: bones
кость: bone
коти: cats
котовъ: of cats
котъ: cat
котꙋ: to the cat
кошꙋлѭ: shirt (accusative)
краиобразъ: landscape
красивє: beautifully
красьна: beautiful (feminine)
красьни: beautiful (plural)
красьно: beautiful (neuter)
красьнъ: beautiful (masculine)
красьнъи: beautiful
красьнє: beautifully
кратъка: short (feminine)
кратъки: short (plural)
краѥ: at the end
крꙋгъ: circle
къ: to, towards
къгда: when
кълбаса: sausage
кълбасꙑ: of the sausage
кънигꙑ: books
къто: who
кътори: which
кꙋдꙑ: where to
кꙋлтꙋроѭ: with culture
кꙋпила: she bought
кꙋпимъ: we will buy
кꙋпити: to buy
кꙋпьць: merchant
кꙋпꙋѥмъ: we buy
кꙋпꙋѥтъ: he/she/it buys
кꙋпꙋѭтъ: they buy
кꙋсъ: piece
кꙋхаромъ: with a cook
кꙋхаръ: cook
кꙋхъниѥ: of the kitchen
кꙋхъниꙗ: kitchen
кꙑсла: sour (feminine)
кꙑсълъ: sour (masculine)
лампа: lamp
ли: if, whether
лимонъ: lemon
лимонꙋ: to the lemon
линиѥи: of the line
линиꙗ: line
листъ: leaf
листꙑ: leaves
лицє: face
ложитъ: he/she/it puts
ложька: spoon
любимъ: we love
любимъи: beloved
любити: to love
любитъ: he/she/it loves
любиши: you (singular) love
люблѭ: I love
любовь: love
любъви: of love
любѧтъ: they love
людамъ: to the people
люди: people
людии: of people
людꙑ: people (accusative)
лєжати: to lie down
лєжитъ: he/she/it is lying down
лєжѧтъ: they are lying down
лєпьшє: better
лєсъ: forest
лѣво: left
лѣниви: lazy (plural)
лѣнивъ: lazy (masculine)
лѣпьшє: better
лѣпьѥ: better
лѣсъ: forest
лѣта: years
лѣто: summer
лѣтꙋ: in summer
лꙋна: moon
магазина: of the store
магазинꙋ: to the store
маи: May
мала: small (feminine)
малъи: small
малѥвати: to paint
малѥѥмъ: we paint
малѥѥтъ: he/she/it paints
малѥѭ: I paint
мапа: map
мапѣ: on the map
марта: of March
масла: of butter
масло: butter, oil
масломъ: with butter
масꙑ: of the mass
материѭ: with mother
мати: mother
матиматика: mathematics
мили: dear (plural)
милъ: dear (masculine)
милꙑ: dear (plural)
минꙋта: minute
минꙋтъ: of minutes
миска: bowl
мискѣ: in the bowl
млада: young (feminine)
млади: young (plural)
младъ: young (masculine)
млѣка: of milk
млѣко: milk
модро: blue (neuter)
модръ: blue (masculine)
модрє: blue (plural)
модрꙋ: blue (accusative)
можьно: possible
можєтъ: he/she/it can
можєтє: you (plural) can
мозгъ: brain
мои: my (plural)
моимъ: with my
мокра: wet (feminine)
мокръ: wet (masculine)
молъчати: to be silent
молъчитъ: he/she/it is silent
морѥ: sea
моста: of the bridge
мостъ: bridge
мостꙋ: to the bridge
моѥ: my (neuter)
моѥѩ: of my (feminine)
моѥѭ: with my (feminine)
моꙗ: my (feminine)
мраза: of the frost
мразъ: frost
мьного: much, many
мьнѣ: to me
мєдъвѣдь: bear
мєдъвѣдꙋ: to the bear
мєждꙋ: between
мєлонъ: melon
мєньѥ: menu
мєнє: me
мєтхода: of the method
мєтходъ: method
мѣнѧѭтъ: they change
мѣсѧць: month, moon
мѣсѧцємъ: with a month
мѧкъка: soft (feminine)
мѧсо: meat
мѫдра: wise (feminine)
мѫдри: wise (plural)
мѫдръ: wise (masculine)
мѫдрє: wisely
мѫжь: husband, man
мѫжьѥвъ: of the husband
мѫжємъ: with a husband
мꙋзика: music
мꙋзикѫ: music (accusative)
мꙋзикꙋ: music (accusative)
мꙑ: we
мꙑслитъ: he/she/it thinks
мꙑши: mice
мꙑшь: mouse
на: on, to
надъ: above
налѣво: to the left
нами: with us
наполънѥна: filled (feminine)
направо: to the right
напълънѥло: filled (neuter)
народовъ: of the peoples
народъ: people, nation
насъ: us
натꙋральна: natural (feminine)
нашеѭ: with our
нашьти: our
низъка: low (feminine)
низъкъи: low
ничьто: nothing
ничєсого: of nothing
нова: new (feminine)
нови: new (plural)
ново: new (neuter)
новъи: new
новємврїи: in November
новꙋ: new (accusative)
нога: leg, foot
ногавицє: trousers
ноги: legs, feet
ногѫ: leg (accusative)
ножомъ: with a knife
ножь: knife
ножє: knives
носилъ: he carried
носимъ: we carry
носити: to carry, to wear
носитъ: he/she/it carries
носъ: nose
нощи: of the night
нощь: night
нъ: but
нє: no, not
нєбо: sky, heaven
нєбꙋ: to the sky
нєдѣлꙗ: Sunday, week
нєже: than
нємаѥтъ: he/she/it doesn't have
нєсти: to carry
нєсєтъ: he/she/it carries
нєсѫтъ: they carry
нѣмьць: German
нѣмьчьскомъ: in German
нѥго: him, it
нꙋдьна: boring (feminine)
нꙋла: zero
о: about, on
облаковъ: of clouds
облакъ: cloud
облаци: clouds
облачьно: cloudy
обликъ: shape, form
облѣкати: to dress
облѣкаѣлъ: he dressed
облѣкаѥтъ: he/she/it dresses
образъ: picture, image
образꙑ: pictures, images
обрꙑсъ: outline, sketch
обѣдъ: lunch
обꙋвъки: shoes
обꙋвъкꙑ: shoes
обꙋвька: shoe
ограничєна: limited (feminine)
одєждꙑ: of clothes
одєжь: clothes
одѣждѫ: clothes (accusative)
окна: windows
окно: window
око: eye
октѡврїи: in October
она: she
они: they (masculine)
оно: it
онъ: he
онꙑ: they (feminine/neuter)
ораньжєвъ: orange (masculine)
ораньжєвѫ: orange (accusative)
осмои: eighth
осмъ: eight
осмь: eight
осмьдесѧть: eighty
осмьнадесѧть: eighteen
осмьстъ: eight hundred
основьнє: basic
остражьнъ: careful
остръи: sharp
отцомъ: with a father
отъ: from
отъворєна: open (feminine)
отъворѥнъи: open
отъкрꙑто: open
отьпочинька: of rest
отьпочѭ: I will rest
отєць: father
оу: at, by
оувидиши: you will see
оувѣрьѥнъи: sure, confident
оужє: already
оутро: morning
оутромъ: in the morning
оухо: ear
оухомъ: with an ear
оучимо: we learn
оучимъ: we learn
оучити: to learn, to teach
оучитъ: he/she/it learns/teaches
оучитє: you (plural) learn/teach
оучитєль: teacher (male)
оучитєлька: teacher (female)
оучитєлѥмъ: with a teacher
оучєникамъ: to the students
оучєникомъ: with a student
оучєникъ: student
офисꙋ: to the office
очи: eyes
очию: of the eyes
падати: to fall
падаѥтъ: it falls
падаѭщи: falling
палачинька: pancake
палмєнь: (unclear, possibly a name or a type of food)
палѥто: pallet
папиръ: paper
папирѣ: on paper
папирꙋ: to the paper
пардонъ: sorry, pardon
паркъ: park
пива: of beer
пиво: beer
пижама: pajamas
писарь: scribe, clerk
писати: to write
письма: letters
пити: to drink
пицѫ: pizza (accusative)
пишємъ: we write
пишєтъ: he/she/it writes
пишѫ: I write
пиѥмъ: we drink
пиѥтъ: he/she/it drinks
пиѥши: you (singular) drink
плаваниѥ: swimming
плавати: to swim
плаваѥмъ: we swim
плави: he/she/it swims
пламєни: of the flame
планъ: plan
по: after, along
повъратокъ: return
повъратъка: return
повьтори: repeat (imperative)
погода: weather
подлогѣ: on the floor
подобьно: similarly
подобьнъ: similar
подъ: under
подьписанъи: signed
подꙋшька: pillow
поздрави: greetings
поздравъ: greeting
поздьно: late
показати: to show
показовати: to show
показоваѥтъ: he/she/it shows
покои: room
покоꙗ: of the room
полица: shelf
полицииникъ: policeman
полиѥ: field
полиѭ: field (accusative)
полиꙗми: with fields
полънощи: of midnight
полънощь: midnight
полєи: of the field
полѥска: Polish (feminine)
полѥскꙑ: Polish (plural)
полѭкомъ: with a Pole
полѭкъ: Pole
помагали: they helped
помагати: to help
помагаѥмъ: we help
помагаѥтъ: he/she/it helps
помараньча: orange (fruit)
помараньчє: orange (adjective neuter)
помогла: she helped
понєдѣлъкъ: Monday
понєдѣлъкꙋ: on Monday
портрєтъ: portrait
послѣдьнъи: last
постєлѥ: in bed
постєлѭ: bed (accusative)
потомъ: then, after
потрѣбовати: to need
походъ: trip, hike
поѥздовъ: of trains
поѥздъ: train
правилѫ: rule
право: right, law
празбито: broken
працьѥвати: to work
працьѥтъ: he/she/it works
при: at, near
принесєтъ: he/she/it will bring
приѥмьнъ: pleasant
приꙗтєль: friend
приꙗтєльѥ: of the friend
приꙗтєльѥвъ: of the friend
приꙗтєлѥмъ: with a friend
приꙗтєлꙗми: with friends
пробовати: to try
пробоѥтъ: he/she/it tries
продавати: to sell
продавьць: seller
продавьцꙋ: to the seller
продаѥтъ: he/she/it sells
просимъ: please, we ask
проспєкъть: avenue
просто: simply
простъи: simple
пръвои: first
пръвомъ: in the first
пръвъ: first
пръвъи: first
пръстъ: finger
прєдъметъ: object, subject
прємо: very
прѣдъ: before, in front of
прѣстрашьно: terribly
прѣстрашьнъ: terrible
птица: bird
птицамъ: to the birds
птици: birds
пълъна: full (feminine)
пълънъ: full (masculine)
пълънъи: full
пьсовъ: of dogs
пьсꙋ: to the dog
пєпрьца: of pepper
пєпрьць: pepper
пєро: feather, pen
пєромъ: with a pen
пєсъ: dog
пѣвамъ: we sing
пѣваѥтъ: he/she/it sings
пѣсниѥ: of the song
пѣти: to sing
пѧта: five
пѧтои: fifth
пѧтъ: five
пѧтъкомъ: on Friday
пѧтъкъ: Friday
пѧть: five
пѧтьдесѧть: fifty
пѧтьнадесѧть: fifteen
пѧтьстъ: five hundred
пꙋнктъ: point
пꙋста: empty (feminine)
пꙋть: way, path
пꙋтьствовати: to travel
пꙋтьствоѥтъ: he/she/it travels
пꙑтати: to ask
пꙑтаѥтъ: he/she/it asks
пꙑтаѭ: I ask
работали: they worked
работати: to work
работаѥтъ: he/she/it works
работаѭ: I work
работникъ: worker
работъникъ: worker
работънъи: working
работꙋ: work (accusative)
равьна: equal (feminine)
равьнъ: equal (masculine)
радио: radio
радость: joy
радостьно: joyfully
радостьнъ: joyful
разбито: broken
разꙋмѣлъ: he understood
разꙋмѣмъ: we understand
разꙑ: times
расти: to grow
растєтъ: it grows
растꙋтъ: they grow
роботꙑ: of the robot
ровьно: exactly
родитєль: parent
родоѭ: with the family
родъ: family, kind
роза: rose
рокъ: year
рокꙋ: in the year
романꙑ: novels
росии: of Russia
рєакциꙗ: reaction
рєгионъ: region
рєсторанъ: restaurant
рѣжєтъ: he/she/it cuts
рѣзати: to cut
рѣка: river
рѣкѫ: river (accusative)
рѣкꙑ: of the river
рѣцѣ: in the river
рѫка: hand, arm
рѫкавица: glove
рѫкавиць: of gloves
рѫкавицє: gloves
рѫки: hands, arms
рѫкѫ: hand (accusative)
рꙋблѥвъ: of rubles
рꙋблꙗ: ruble
рꙋсомъ: with a Russian
рꙋсъ: Russian
рꙋсьскаѥго: of Russian
рꙋсьскꙑи: Russian
рꙑба: fish
рꙑбѣ: to the fish
рꙑбѫ: fish (accusative)
рꙑсовати: to draw
рꙑсꙋѥтъ: he/she/it draws
самъ: alone, self
свои: his, her, its, their (own)
своѥѭ: with his/her/its own
своѭ: his/her/its own (accusative)
свѣжа: fresh (feminine)
свѣжь: fresh (masculine)
свѣтити: to shine
свѣтитъ: it shines
свѣтлє: brightly
свѣтофоръ: traffic light
свѣтъло: bright
свѣтълъ: bright
свѧжєтъ: he/she/it will tie
свѧзати: to tie
си: are (2nd person singular)
сиви: gray (plural)
сивъ: gray (masculine)
силььна: strong (feminine)
силььно: strongly
силььнъ: strong (masculine)
силььнъи: strong
символъ: symbol
ситꙋацию: situation (accusative)
сковъродъка: frying pan
сковъродъцѣ: in the frying pan
скоро: soon
скринѥ: box
скрꙑвати: to hide
скрꙑваѥтъ: he/she/it hides
слаби: weak (plural)
слабъ: weak (masculine)
сладъкъ: sweet (masculine)
сладъкъи: sweet
сладъкє: sweet (neuter)
сладъкѫ: sweet (accusative)
слива: plum
сливовицѫ: plum brandy (accusative)
сливокъ: of plums
слова: words
словѣниномъ: by a Slovene
словѣнинъ: Slovene
словѣньскомъ: in Slavic
словѣньскꙑи: Slavic
сложьнъ: difficult
слъньца: of the sun
слъньцъ: of the sun
слъньцє: sun
слꙋшати: to listen
слꙋшаѭтъ: they listen
слꙑшалъ: he heard
слꙑшати: to hear
слꙑшитъ: he/she/it hears
смѣлъ: he dared
смѣїти: to laugh
смѣѥтъ: he/she/it laughs
снѣга: of snow
снѣгомъ: with snow
снѣгъ: snow
собоѭ: with oneself
собѣ: to oneself
сока: of juice
сокъ: juice
соли: of salt
спати: to sleep
спитъ: he/she/it sleeps
спокои: peace
спокоинои: of peace
спокойно: calmly
спокойноѥго: of calm
спорта: of sport
спортъ: sport
спортъовъ: of sports
спортꙋ: to sport
спортꙋѭтъ: they do sports
срамъ: shame
срамьнъ: shameful
сръдьцє: heart
срьци: in the heart
срєбръна: silver (feminine)
срєдъинѣ: in the middle
срѣда: Wednesday
срѣдꙋ: Wednesday (accusative)
стадионъ: stadium
стадионѣ: at the stadium
стаи: rooms
станициꙗ: station
станицю: station (accusative)
стара: old (feminine)
стари: old (plural)
старъ: old (masculine)
старꙋ: old (accusative)
стои: it costs, it stands
стоимъ: we stand
стола: of the table
столица: capital city
столомъ: with a table
столъ: table
столѣ: on the table
стопа: foot
стопꙑ: of the foot
стоꙗти: to stand
страна: country, side
странъ: of countries
странѫ: country (accusative)
странꙑ: of the country
страхъ: fear
строи: he/she/it builds
строѥмь: we build
стѣна: wall
стѣнѣ: on the wall
стꙋдєнтами: with students
стꙋлъ: chair
стꙑдъ: shame
стꙑдьно: shameful
съ: with
съна: of a dream
сънъ: dream, sleep
съто: hundred
сътънъ: hundredth
сь: this
сьнижькѫ: snowflake (accusative)
сє: this
сєдмъ: seven
сєдмь: seven
сєдмьдесѧть: seventy
сєдмьнадесѧть: seventeen
сєдмьстъ: seven hundred
сєзономъ: with the season
сєзонъ: season
сєзонꙑ: seasons
сєкꙋнда: second
сєкꙋндъ: of seconds
сєптємврїи: in September
сєриѭ: series (accusative)
сєстра: sister
сєстроѭ: with a sister
сєстрѫ: sister (accusative)
сѣвєра: of the north
сѣвєро-западънъи: north-western
сѣвєръ: north
сѣвєрьна: northern (feminine)
сѣвєрьнъ: northern (masculine)
сѣвєрꙋ: to the north
сѣдитъ: he/she/it sits
сѣдєтъ: he/she/it sits
sѣдѣниѥ: of sitting
сѣдѣти: to sit
сѣсти: to sit down
сѧ: oneself (reflexive pronoun)
сѫбота: Saturday
сѫтъ: they are
сꙋкънѭ: with a dress
сꙋхо: dry (neuter)
сꙑномъ: with a son
сꙑнъ: son
сꙑра: of cheese
сꙑръ: cheese
та: that, she
тако: so, thus
талирька: plate
тамъ: there
тамьси: there you are
тамьсь: there
тамьтъ: that one there
тамьтъи: that one there
таньцьѥвати: to dance
таньцьѥѭ: I dance
твои: your (plural)
твоимъ: with your
творбꙋ: creation (accusative)
твоѥѭ: with your (feminine)
твоѭ: your (accusative)
тиха: quiet (feminine)
тихи: quiet (plural)
тихъ: quiet (masculine)
тихъи: quiet
тобоѭ: with you
тобѣ: to you
того: of that
тои: that
томъ: in that
томꙋ: to that
торба: bag
торбѣ: in the bag
торбѫ: bag (accusative)
точка: point, dot
трава: grass
травѫ: grass (accusative)
три: three
тридесѧтъи: thirtieth
тридесѧть: thirty
трикѫтьникъ: triangle
тринадесѧть: thirteen
тристє: three hundred
тръвати: to last
тръваѥтъ: it lasts
тръга: of the market
тръгъ: market
тръгꙋ: at the market
тръпѣти: to suffer, to be patient
трєновати: to train
трєнꙋѥтъ: he/she/it trains
трєпєтъ: it trembles
трєтии: third
трєтьѥмъ: in the third
трєтєи: third
трѣба: need
тъ: that, he
тъждє: also
тъи: that
тълико: so much
търговищи: at the market
търговищє: market
тьмьна: dark (feminine)
тьмьни: dark (plural)
тьмьнъ: dark (masculine)
тьмьнє: dark (neuter)
тєбє: you
тєниска: t-shirt
тєнискѫ: t-shirt (accusative)
тєнисъ: tennis
тєпла: warm (feminine)
тєпло: warm (neuter)
тєплъи: warm
тєплє: warmly
тєтка: aunt
тєткоѭ: with an aunt
тєчєтъ: it flows
тѣло: body
тѣлєснои: of the body
тѣлꙋ: to the body
тѧжька: heavy (feminine)
тѧжькъ: heavy (masculine)
тѧжькє: heavy (neuter)
тѫ: that (accusative feminine)
тꙋ: here
тꙋшь: shower
тꙑ: you (singular)
тꙑждньꙋ: in the week
тꙑждньꙗ: of the week
тꙑжьдьнь: week
тꙑмъ: with that
тꙑсѧщи: thousands
тꙑсѧщнъ: thousandth
тꙑхъ: of those
фигꙋра: figure
фигꙋрꙑ: figures
фильмъ: film, movie
флѧшька: bottle
флѧшькѫ: bottle (accusative)
флѧшькꙑ: bottles
фонтана: of the fountain
форма: form, shape
формꙑ: of the form
франка: of the franc
фєвроѵарии: in February
фєвроѵариꙋ: in February
фꙋтболъ: football, soccer
хвала: praise, thanks
хладънъ: cold
хладьно: cold
хладьнъ: cold
хладьнъи: cold
хлапъци: boys
хлапьць: boy
хлапьцєвъ: of the boy
хлѣба: of bread
хлѣбъ: bread
хокєи: hockey
хондꙋрасъ: Honduras
хотєла: she wanted
хотєлъ: he wanted
хотѣти: to want
хощемъ: we want
хощємъ: we want
хощєтъ: he/she/it wants
хощєши: you (singular) want
хръватка: Croatian (female)
хръваткоѭ: with a Croatian (female)
хръватъ: Croat, Croatian (male)
хръватьскомъ: in Croatian
хꙋда: bad (feminine)
хꙋдъ: bad (masculine)
хꙋдъи: bad
цвѣсти: to bloom
цвѣтъ: flower, color
цвѣтєтъ: it blooms
цвѣтꙋтъ: they bloom
цвѣтꙑ: flowers
црькъвь: church
цєнтра: of the center
цєнтрѣ: in the center
цѣна: price
цѣнꙋ: price (accusative)
цꙋкра: of sugar
цꙋкръ: sugar
чаи: tea
часа: of the hour
часомъ: with the hour
части: parts
частинꙑ: of the part
часто: often
частъ: part
часъ: hour
часъвъниковъ: of the clocks
часъвъникъ: clock, watch
чаша: cup
чашька: cup
чашькѫ: cup (accusative)
чашькꙑ: of the cup
чашѫ: cup (accusative)
чаꙗ: of tea
чиста: clean (feminine)
чистаѥи: of the clean
чистъи: clean
читамъ: I read
читати: to read
читаѥтъ: he/she/it reads
читаѥши: you (singular) read
читаѭ: I read
чловѣкъ: person, man
чрьвєна: red (feminine)
чрьвєно: red (neuter)
чрьвєнъ: red (masculine)
чрьвєнъи: red
чрьвєнє: red (plural)
чрьнє: black (neuter)
чрѣзъ: through
чьмь: with what
чьрна: black (feminine)
чьрно: black (neuter)
чьрнъ: black (masculine)
чьсєго: of what
чьто: what
чєкъ: check
чєтврьтои: fourth
чєтврьтъ: four
чєтврьтъкъ: Thursday
чєтꙑри: four
чєтꙑридесѧть: forty
чєтꙑринадесѧть: fourteen
чєтꙑристє: four hundred
чєтꙑрє: four
чꙋти: to feel, to hear
чꙋѥмъ: we feel
чꙋѥтъ: he/she/it feels
шаликъ: scarf
шапька: hat, cap
шапькѫ: hat (accusative)
шапькꙑ: of the hat
шафа: wardrobe, closet
шахъ: chess
широка: wide (feminine)
широкъо: wide
шити: to sew
шиѥмъ: we sew
шиѥтъ: he/she/it sews
шиѥши: you (singular) sew
шофєръ: driver
шькарпєтька: sock
шькарпєтьки: socks
шькода: damage, pity
шькола: school
шьла: she went
шьли: they went
шьло: it went
шєлъ: he went
шєстои: sixth
шєстъ: six
шєсть: six
шєстьдесѧть: sixty
шєстьнадесѧть: sixteen
шєстьстъ: six hundred
шєстьсътънъ: six hundredth
ыбѣгалъ: he ran away
ыбѣгати: to run away
ылица: street
ылици: on the street
ыморѥнъи: tired
юго-възходъ: southeast
югъ: south
югъ-западꙋ: to the southwest
югꙋ: to the south
южьни: southern (plural)
южьноѩ: of the south
южьнъ: southern
єнєргии: of energy
ѥго: his, its
ѥда: food
ѥдина: one (feminine)
ѥдиница: unit
ѥдино: one (neuter)
ѥдиномъ: in one
ѥдинъ: one (masculine)
ѥдинънадесѧтои: eleventh
ѥдинънадесѧть: eleven
ѥдинѫ: one (accusative)
ѥдоѭ: with food
ѥдєтъ: he/she/it eats
ѥдѫ: food (accusative)
ѥдѫтъ: they eat
ѥдꙑ: of food
ѥзєрꙋ: to the lake
ѥзꙑка: of the language
ѥзꙑкъ: language, tongue
ѥзꙑцѣ: in the language
ѥмоциꙗ: emotion
ѥмъ: I eat
ѥмꙋ: to him
ѥси: you are (singular)
ѥсмъ: I am
ѥсмь: I am
ѥсти: to eat
ѥстъ: he/she/it is
ѥстє: you are (plural)
ѥсєни: in autumn
ѥсєнь: autumn
ѥхати: to go, to ride
ѥщє: still, yet
ѥѩ: her
ѩзꙑкъ: language, tongue
ѩзꙑкꙑ: languages
ꙗ: I
ꙗблъко: apple
ꙗгода: berry
ꙗгодꙑ: berries
ꙗица: eggs
ꙗицє: egg
ꙗко: as, like
ꙗноуарии: January
ꙗноуариꙋ: in January