a: a
about: o
above: nad
add: dodat
added: dodano
afraid: bojao
after: nakon
age: dob
air: zrak
alone: sam
already: već
also: također
always: uvijek
am: sam
an: an
and: i
anger: gnjev
angrily: gnjevno
angry: gnjevan
animal: životinja
anything: išta
apple: jabuka
april: travanj
are: su
artist: umjetnik
as: kao
ashamed: sramotan
ask: pitati
asks: pita
assignment: zadatak
assignments: zadataka
at: kod
at/by: kod
august: kolovoz
aunt: tetka
autumn: jesen
avenue: avenija
away: daleko
bad: loša
bag: torba
banana: banana
bananas: banane
bartek: bartek
basic: osnovne
basketball: košarka
be: biti
bear: medvjed
beats: otkucaja
beautiful: lijep
beautifully: lijepo
because: jer
bed: krevet
beer: pivo
before: prije
behind: iza
better: bolje
between: između
bicycle: bicikl
bicycles: bicikala
big: velik
bird: ptica
birds: pticama
black: crn
blonde: plavuša
bloom: cvjetati
blowing: puše
blue: plav
body: tijelo
bone: kost
bones: kosti
book: knjiga
books: knjige
boring: dosadno
bottle: boca
bottles: boce
bought: kupila
bowl: zdjela
boy: dječak
boys: dječaka
brain: mozak
brandy: rakija
brave: hrabar
bread: kruh
breakfast: doručak
bridge: most
bring: donijeti
broken: razbijen/pokvaren
brother: brat
brothers: braća
brown: kestenjast
building: zgrada
bus: autobus
but: ali
butter: maslac
buy: kupiti
buying: kupuje
by: po
can: može
car: auto
careful: oprezan
carries: nosi
carry: nositi
carrying: nosi
cat: mačka
cats: mačaka
center: centra
chair: stolica
change: promijeniti
changing: mijenja
cheerful: veseo
cheese: sir
cherry: višnja
chess: šah
chest: škrinja
chestnut-colored: kestenjast
child: dijete
children: djeca
church: crkva
cinema: kino
circle: krug
cities: gradovima
city: grad
clean: čist
clock: sat
clock/watch: sat
clocks: satova
closed: zatvorena
clothes: odjeća
cloud: oblak
clouds: oblaci
cloudy: oblačno
coat: kaput
coffee: kava
cold: hladan
color: boja
colors: boje
comes: dolazi
comfortable: udobna
compass: kompas
complex: složen
computer: računalo
computers: računala
connect/tie: povezati
connects: povezuje
controls: kontrolira
conversation: razgovor
cook: kuhar
cooking: kuha
country: država
croat: hrvat
croatian: hrvatskim
culture: kulturom
cup: šalica
customer: kupac
cut: rezati
da: da
dance: plesati
dark: taman
daughter: kćer
day: dan
days: dana
december: prosinac
desk: stol
diary: dnevnik
did: činio
didn't: nije
difficult: teško
dinner: večera
discount: popust
dish: jelo
do: činiti/raditi
do/make: činiti/raditi
doctor: doktor
documents: dokumente
does: radi
dog: pas
dogs: pasa
dollar: dolar
dollars: dolara
don't: nemam
door: vrata
doors: vrata
dot: točka
down: dolje
draw: crtati
drawer: ladica
drawing: crtanje
dream: san
dress: haljina
drink: piti
drinking: pije
drinks: pije
driver: vozač
drives: vozi
dry: suho
dumpling: okruglica
each: svaki
ear: uho
earth: zemlja
east: istok
eastern: istočna
eastward: istočno
eat: jesti
eating: jede
eats: jede
egg: jaje
eggs: jaja
eight: osam
eighteen: osamnaest
eighth: osmi
eighty: osamdeset
eleven: jedanaest
eleventh: jedanaestoj
emotion: emocija
empty: prazna
end: kraj
energy: energije
engineer: inženjer
england: Engleska
english: engleskim
englishman: englez
envy: zavist
evening: večer
every: svaki
everything: sve
excuse: oprostite
expensive: skupo
eye: oko
eyes: oči
face: lice
fall: padati
falling: padajuće
family: obitelj
far: daleko
fast: brz
fat: debeo
father: otac
favorite: omiljeni
fear: strah
february: veljača
feel: osjećati
feels: osjeća
feet: stope
female: žen
field: polje
fields: polja
fifteen: petnaest
fifth: peti
fifty: pedeset
figure: figura
figures: figure
filled: napunjena
film: film
find: naći
finger: prst
first: prvi
fish: riba
five: pet
flame: plamenik
floor: pod
flower: cvijet
flowers: cvijeće
flows: teče
food: hrana
foolish: glup
foot: stopalo
football: nogomet
footwear: obuća
for: za
forest: šuma
fork: vilica
forks: vilice
forty: četrdeset
fountain: fontana
four: četiri
fourteen: četrnaest
fourth: četvrti
frank: franak
fresh: svjež
friday: petak
friend: prijatelj
friends: prijatelji
frightened: prestrašen
frog: žaba
from: iz
frost: mraz
frying: tava
full: pun
game: igra
german: nijemac
germany: njemačkoj
gift: dar
girl: djevojka
give: dati
gives: daje
glass: staklo
glove: rukavica
gloves: rukavice
go: ići
go/drive: ići
god: bogom
goes: ide
going: ide
gone: otišao
good: dobar
granddaughter: unuka
grandfather: djed
grandmother: baka
grandson: unuk
grapes: grožđe
grass: trava
green: zelen
greener: zeleniji
greet: pozdravi
greeting: pozdrav
greetings: pozdravi
grey: siv
ground: zemlja
group: grupom
grow: rasti
grows: raste
guitar: gitaru
had: imao
hair: kosa
hand: ruka
hands: ruke
hang: visjeti
hangs: visi
has: ima
hat: kapa
have: imati
having: ima
he: on
he/she/it: on/ona/ono
head: glava
health: zdravlje
healthy: zdrav
healthy/hello: zdrav/bok
hear: čuti
hears: čuje
heart: srce
heat: grijati
heats: grije
heavy: težak
hello: zdravo
help: pomagati
helped: pomogla
helps: pomaže
her: njezina
here: ovdje
hide: skrivati
hides: skriva
high: visok
him: mu
himself: sebi
his: njegov
hockey: hokej
hold: držati
holds: drži
home: dom
honduras: honduras
horse: konj
hot: vruć
hotel: hotel
hour: sat
house: kuća
houses: domova
how: kako
hundred: sto
hundredth: stoti
hurt: boljeti
hurts: boli
i: ja
i'm: sam
if: ako
important: važan
in: u
ink: tinta
inside: iznutra
interesting: zanimljiv
into: u
is: je
isn't: nije
it: to
january: siječanj
jealous: zavidno
joy: radost
joyful: radostan
joyfully: radosno
juice: sok
july: srpanj
june: lipanj
just: samo
kind: vrsta
kitchen: kuhinja
knife: nož
knives: noževi
know: znati
known: zna
knows: zna
lake: jezeru
lamp: lampa
landscape: krajolik
language: jezik
languages: jezici
larger: veći
last: zadnji
late: prekasno
laugh: smijati
laughs: smije
lazy: lijen
lead: voditi
leads: vodi
leaf: list
learn: učiti
learning: uči
leaves: lišće
left: lijevo
leg: noga
legs: noge
lemon: limun
less: manje
let's: idemo
letters: pisma
library: biblioteka
lie: ležati
lies: leži
light: svjetlo
like: voljeti/sviđati
likes: voli
limit: ograničena
limited: ograničena
line: linija
listen: slušati
listening: slušaju
live: živjeti
lives: živi
long: dug
looking: gleda
lot: mnogo
louder: glasnije
love: ljubav
love/like: voljeti/sviđati
lunch: ručak
lying: leži
made: napravljen
makes: čini
male: muš
man: čovjek
many: mnogo
map: karta
march: ožujak
market: tržnica
mass: mase
mathematics: matematika
may: svibanj
maybe: možda
maybe/can: možda
me: mene
mean: znači
meat: meso
melon: dinja
men: muškaraca
method: metoda
middle: sredini
midnight: ponoć
milk: mlijeko
minute: minuta
minutes: sekundi
mirror: zrcalo
monday: ponedjeljak
month: mjesec
moon: mjesec
more: više
morning: jutro
mother: majka
mountain: gora
mountains: planine
mouse: miš
movies: film
much: koliko
music: glazba
my: moj
myši: mišu
name: ime
nation: narod
nations: naroda
natural: prirodna
near: blizu
nearest: najbliži
necessary: treba
need: trebati
needed: trebalo
needs: treba
new: nov
night: noć
nine: devet
nineteen: devetnaest
ninety: devedeset
ninth: deveti
no: ne
north: sjever
northern: sjeverna
northwestern: sjeverozapadni
nose: nos
not: ne
note: bilješki
notebook: bilježnica
notes: bilješki
nothing: ništa
novels: romane
november: studeni
now: sada
oak: hrast
october: listopad
of: od
office: ured
often: često
old: star
on: na
one: jedan
only: samo
open: otvoren
or: ili
orange: naranča
oranges: naranče
other: drugi
others: drugi
our: našom
outline: obris
over: preko
paint: slikati
painting: slika
pajama: pidžama
pajamas: pidžama
pan: tava
pancake: palačinka
paper: papir
pardon: pardon/oprostite
parent: roditelj
park: park
past: prošlost
path/way: put
peace: mir
peaceful: miran
pear: kruška
pears: kruške
pen: pero
people: ljudi
pepper: papar
perhaps: možda
person: osoba
picture: slika
pictures: slike
piece: komad
pillow: jastuk
pity: šteta
pizza: pizzu
plan: plan
plate: tanjur
play: igrati
playing: igra
plays: igra
pleasant: ugodan
please: molim
plum: šljiva
plums: šljive
point: točka
poland: Poljska
pole: Poljak
policeman: policajac
portrait: portret
possible: moguće
pot: lonac
prepare: priprema
preparing: priprema
price: cijena
proud: ponosan
proudly: ponosno
put: staviti
putting: stavlja
quick: brz
quickly: brzo
quiet: tih
radio: radio
rain: kiša
raining: kiša
ran: pobjegao
reaction: reakcija
read: čitati
reading: čita
ready: spreman
receipt: račun
red: crven
region: region
regions: regioni
repeat: ponovi
rest: odmor
restaurant: restoran
return: povrat
returns: povrat
rich: bogatom
right: desno
ripe: zreo
rise: ustati
rises: ustaje
river: rijeka
road: cesta
room: soba
rose: ruža
ruble: rubalj
rubles: rubalja
run: trčati
running: trčanje
runs: trči
russia: Rusiji
russian: ruski
sad: žalostan/tužan
sadly: žalostno/tužno
sadness: tugu
salt: sol
saturday: subota
sausage: kobasica
says: kaže
scarf: šal
school: škola
sea: more
season: sezona
seasons: sezone
seat: sjedenje
second: sekunda
seconds: sekundi
security: sigurnost
see: vidjeti
sees: vidi
sell: prodavati
seller: prodavač
sells: prodaje
september: rujan
series: seriju
sets: zalazi
seven: sedam
seventeen: sedamnaest
seventh: sedmi
seventy: sedamdeset
sew: šivati
sewing: šiva
shame: sram
shape: oblik
shapes: oblici
sharp: oštar
she: ona
shelf: polica
shine: sjati
shines: sjaji
shining: svijetli
shirt: košulja
shoe: cipela
shoes: cipele
shop: trgovina
shop/store: trgovina
short: kratka
shorter: kraći
shorts: kratke
show: pokazati
shows: pokazuje
side: strana
sides: strane
signed: potpisan
silent: šutjeti
silver: srebrna
similar: sličan
simple: jednostavan
sincere: iskren
sing: pjevati
singing: pjeva
sister: sestra
sit: sjediti
sitting: sjedenje
situation: situaciju
six: šest
sixteen: šesnaest
sixth: šesti
sixty: šezdeset
skin: koža
sky: nebo
slav: Slaven
slavic: slavenski
sleep: spavati
sleeps: spava
small: mala
smart: pametan
smell: miris
smells: miriše
smooth: glatka
snow: snijeg
so: tako
sock: čarapa
socks: čarape
soft: mekan
sometimes: ponekad
son: sin
songs: pjesme
soon: uskoro
soul: duše
sour: kiseo
south: jug
southeast: jugoistok
southern: južne
southwest: jugozapad
speak: govoriti
speaks: govori
speed: brzina
spirit: duh
spoke: govorio
spoon: žlica
sport: sport
sports: sportaše
spring: proljeće
square: kvadrat
square/market: trg
stable: stabilan
stadium: stadion
stand: stajati
standing: stoji
stands: stoji
star: zvijezda
stars: zvijezde
station: stanica
stays: ostaje
still: još
stomach: želudac
stone: kamen
stones: kamenje
stops: zaustavlja
straight: ravno
strawberries: jagode
strawberry: jagoda
street: ulica
strong: snažan
stronger: jači
strongly: jako
student: učenik
students: učenicima
stupid: glup
subject: predmet
suffer: trpjeti
sugar: šećer
summer: ljeto
sun: sunce
sunday: nedjelja
suns: sunaca
sure: siguran
sweet: sladak
swim: plivati
swimming: plivanje
symbol: simbol
syr: sir
t-shirt: majica
table: stol
talk: razgovarati
talking: razgovaram
talks: razgovara
tall: visok
taller: viši
taller/higher: viši
talt: talt
tasty: ukusna
tea: čaj
teacher: učitelj
tells: kaže
ten: deset
tennis: tenis
tenth: desetoj
than: nego
thank: hvala
thanks: hvala
that: taj
the: the
their: njihov
them: ih
then: zatim
there: tamo
these: ove
they: oni
thin: tanak
thing: stvar
things: stvari
think: misli
thinner: tanji
third: treći
thirteen: trinaest
thirtieth: trideseti
thirty: trideset
this: ovaj
those: one
thousand: tisuća
thousandth: tisućiti
three: tri
through: kroz
thursday: četvrtak
time: vrijeme
times: puta
tired: umoran
to: do
today: danas
tomorrow: sutra
too: previše
towards: prema
traffic: promet
train: vlak
trains: vlakova
travel: putovati
travels: putuje
tree: drvo
trees: drveća
tremor: drhtanje/strah
triangle: trokut
troubling: dosadno
trousers: hlače
truth: istinu
try: probati
trying: probava
tuesday: utorak
twelfth: dvanaestoj
twelve: dvanaest
twenty: dvadeset
two: dva
ugly: ružan
uncle: stric
under: pod
understand: razumijem
underwear: gaće
unit: jedinica
universe: svemir
until: do
us: nas
vacation: odmor
valley: dolina
valuable: dragocjen
very: vrlo
vineyard: vinogradu
vlad: vlad
vodka: votke
walk: šetnju
walking: hoda
wall: zid
want: htjeti
wardrobe: ormar
warm: topao
warms: grije
was: bio
watch: sat
watching: gleda
water: voda
way: put
we: mi
weak: slab
wear: nositi
wearing: nosi
wears: nosi
weather: vrijeme
wednesday: srijeda
week: tjedan
weekend: vikend
welcome: dobrodošli
well: dobro
went: išao
went/walked: išao
were: bili
west: zapad
western: zapadni
wet: mokar
what: što
when: kad
where: gdje
which: koji
white: bijel
who: tko
wide: široka
wife: žena
will: će
wind: vjetar
window: prozor
windows: prozora
wine: vino
winter: zima
wise: mudar
wiser: mudriji
with: sa
within: unutra
without: bez
wolf: vuk
woman: žena
women: žene
wood: drvo
words: riječi
wore: nosio
work: rad
worker: radnik
working: radi
works: radi
would: bi
write: pisati
writer: pisar
writes: piše
writing: piše
year: godina
year's: godine
yellow: žut
yes: da
yesterday: jučer
you: ti
young: mlad
your: tvoj
zero: nula