a: а
about: пра
above: над
add: дадаваць
added: дадаў
afraid: напалоханы
after: пасля
age: узрост
air: паветра
alone: адзін
already: ужо
also: таксама
always: заўсёды
am: ёсць
an: а
and: і
anger: гнеў
angrily: злосна
angry: злы
animal: жывёла
anything: што-небудзь
apple: яблык
april: красавік
are: ёсць
artist: мастак
as: як
ashamed: прысаромлены
ask: пытаць
asks: пытаецца
assignment: заданне
assignments: заданні
at: у
at/by: у/ля
august: жнівень
aunt: цётка
autumn: восень
avenue: праспект
away: далёка
bad: дрэнны
bag: сумка
banana: банан
bananas: бананы
bartek: бартэк
basic: базавы
basketball: баскетбол
be: быць
bear: мядзведзь
beats: б'е
beautiful: прыгожы
beautifully: прыгожа
because: таму што
bed: ложак
beer: піва
before: перад
behind: за
better: лепш
between: паміж
bicycle: ровар
bicycles: ровары
big: вялікі
bird: птушка
birds: птушкі
black: чорны
blonde: бландзінка
bloom: цвісці
blowing: дзьме
blue: сіні
body: цела
bone: костка
bones: косткі
book: кніга
books: кнігі
boring: сумны
bottle: бутэлька
bottles: бутэлькі
bought: купіў
bowl: міска
boy: хлопчык
boys: хлопчыкі
brain: мозг
brandy: брэндзі
brave: адважны
bread: хлеб
breakfast: сняданак
bridge: мост
bring: прыносіць
broken: зламаны
brother: брат
brothers: браты
brown: карычневы
building: будынак
bus: аўтобус
but: але
butter: масла
buy: купляць
buying: купляе
by: па
can: можа
car: машына
careful: асцярожны
carries: нясе
carry: несці
carrying: нясе
cat: кот
cats: каты
center: цэнтр
chair: крэсла
change: змяняць
changing: змяняецца
cheerful: вясёлы
cheese: сыр
cherry: вішня
chess: шахматы
chest: грудзі
chestnut-colored: каштанавы
child: дзіця
children: дзеці
church: царква
cinema: кіно
circle: круг
cities: гарады
city: горад
clean: чысты
clock: гадзіннік
clock/watch: гадзіннік/назіраць
clocks: гадзіннікі
closed: закрыты
clothes: адзенне
cloud: воблака
clouds: аблокі
cloudy: воблачна
coat: паліто
coffee: кава
cold: халодны
color: колер
colors: колеры
comes: прыходзіць
comfortable: камфортны
compass: компас
complex: складаны
computer: камп'ютар
computers: камп'ютары
connect/tie: злучыць/завязаць
connects: злучае
controls: кантралюе
conversation: размова
cook: гатаваць
cooking: гатаванне
country: краіна
croat: харват
croatian: харвацкая
culture: культура
cup: кубак
customer: кліент
cut: рэзаць
da: да
dance: танцаваць
dark: цёмны
daughter: дачка
day: дзень
days: дні
december: снежань
desk: стол
diary: дзённік
did: зрабіў
didn't: не рабіў
difficult: складаны
dinner: вячэра
discount: зніжка
dish: страва
do: рабіць
do/make: рабіць/ствараць
doctor: доктар
documents: дакументы
does: робіць
dog: сабака
dogs: сабакі
dollar: долар
dollars: долары
don't: не
door: дзверы
doors: дзверы
dot: кропка
down: уніз
draw: маляваць
drawer: скрыня
drawing: маляванне
dream: мара
dress: сукенка
drink: піць
drinking: п'е
drinks: напоі
driver: кіроўца
drives: водзіць
dry: сухі
dumpling: клёцкі
each: кожны
ear: вуха
earth: зямля
east: усход
eastern: усходні
eastward: на ўсход
eat: есці
eating: есць
eats: есць
egg: яйка
eggs: яйкі
eight: восем
eighteen: васемнаццаць
eighth: восьмы
eighty: восемдзесят
eleven: адзінаццаць
eleventh: адзінаццаты
emotion: эмоцыя
empty: пусты
end: канец
energy: энергія
engineer: інжынер
england: англія
english: англійская
englishman: англічанін
envy: зайздрасць
evening: вечар
every: кожны
everything: усё
excuse: прабачэнне
expensive: дарагі
eye: вока
eyes: вочы
face: твар
fall: падаць
falling: падае
family: сям'я
far: далёка
fast: хуткі
fat: тоўсты
father: бацька
favorite: любімы
fear: страх
february: люты
feel: адчуваць
feels: адчувае
feet: ногі
female: жаночы
field: поле
fields: палі
fifteen: пятнаццаць
fifth: пяты
fifty: пяцьдзесят
figure: фігура
figures: фігуры
filled: напоўнены
film: фільм
find: знаходзіць
finger: палец
first: першы
fish: рыба
five: пяць
flame: полымя
floor: падлога
flower: кветка
flowers: кветкі
flows: цячэ
food: ежа
foolish: дурны
foot: нага
football: футбол
footwear: абутак
for: для
forest: лес
fork: відэлец
forks: відэльцы
forty: сорак
fountain: фантан
four: чатыры
fourteen: чатырнаццаць
fourth: чацвёрты
frank: франк
fresh: свежы
friday: пятніца
friend: сябар
friends: сябры
frightened: напалоханы
frog: жаба
from: з
frost: мароз
frying: смажыць
full: поўны
game: гульня
german: нямецкі
germany: германія
gift: падарунак
girl: дзяўчынка
give: даваць
gives: дае
glass: шклянка
glove: пальчатка
gloves: пальчаткі
go: ісці
go/drive: ісці/ехаць
god: бог
goes: ідзе
going: ідзе
gone: пайшоў
good: добры
granddaughter: ўнучка
grandfather: дзед
grandmother: бабуля
grandson: унук
grapes: вінаград
grass: трава
green: зялёны
greener: зелянейшы
greet: вітаць
greeting: прывітанне
greetings: прывітанні
grey: шэры
ground: зямля
group: група
grow: расці
grows: расце
guitar: гітара
had: меў
hair: валасы
hand: рука
hands: рукі
hang: вісець
hangs: вісіць
has: мае
hat: капялюш
have: мець
having: мае
he: ён
he/she/it: ён/яна/яно
head: галава
health: здароўе
healthy: здаровы
healthy/hello: здаровы/прывітанне
hear: чуць
hears: чуе
heart: сэрца
heat: цяпло
heats: грэе
heavy: цяжкі
hello: прывітанне
help: дапамагчы
helped: дапамог
helps: дапамагае
her: яе
here: тут
hide: хаваць
hides: хавае
high: высокі
him: яго
himself: сам
his: яго
hockey: хакей
hold: трымаць
holds: трымае
home: дом
honduras: гандурас
horse: конь
hot: гарачы
hotel: гатэль
hour: гадзіна
house: дом
houses: дамы
how: як
hundred: сто
hundredth: соты
hurt: балюча
hurts: баліць
husband: муж
i: я
i'm: я
if: калі
important: важны
in: у
ink: чарніла
inside: унутры
interesting: цікавы
into: у
is: ёсць
isn't: не
it: яно
january: студзень
jealous: раўнівы
joy: радасць
joyful: радасны
joyfully: радасна
juice: сок
july: ліпень
june: чэрвень
just: проста
kind: добры
kitchen: кухня
knife: нож
knives: нажы
know: ведаць
known: вядомы
knows: ведае
lake: возера
lamp: лямпа
landscape: пейзаж
language: мова
languages: мовы
larger: большы
last: апошні
late: позні
laugh: смяяцца
laughs: смяецца
lazy: лянівы
lead: весці
leads: вядзе
leaf: ліст
learn: вучыцца
learning: вучыцца
leaves: пакідае
left: левы
leg: нага
legs: ногі
lemon: лімон
less: менш
let's: давайце
letters: літары
library: бібліятэка
lie: хлусіць
lies: хлусіць
light: святло
like: падабацца
likes: падабаецца
limit: мяжа
limited: абмежаваны
line: лінія
listen: слухаць
listening: слухае
live: жыць
lives: жыве
long: доўгі
looking: глядзіць
lot: шмат
louder: гучней
love: каханне
love/like: каханне/падабаецца
lunch: абед
lying: ляжаць
made: зрабіў
makes: робіць
male: мужчынскі
man: мужчына
many: шмат
map: карта
march: сакавік
market: рынак
mass: маса
mathematics: матэматыка
may: можа
maybe: можа быць
maybe/can: можа быць/можа
me: мне
mean: азначаць
meat: мяса
melon: дыня
men: мужчыны
method: метад
middle: сярэдзіна
midnight: поўнач
milk: малако
minute: хвіліна
minutes: хвіліны
mirror: люстэрка
monday: панядзелак
month: месяц
moon: месяц
more: больш
morning: раніца
mother: маці
mountain: гара
mountains: горы
mouse: мыш
movies: фільмы
much: шмат
music: музыка
my: мой
myši: мышы
name: імя
nation: нацыя
nations: нацыі
natural: натуральны
near: каля
nearest: бліжэйшы
necessary: неабходны
need: патрэба
needed: патрэбны
needs: патрэбы
new: новы
night: ноч
nine: дзевяць
nineteen: дзевятнаццаць
ninety: дзевяноста
ninth: дзевяты
no: не
north: поўнач
northern: паўночны
northwestern: паўночна-заходні
nose: нос
not: не
note: запіс
notebook: нататнік
notes: нататкі
nothing: нічога
novels: раманы
november: лістапад
now: зараз
oak: дуб
october: кастрычнік
of: з
office: офіс
often: часта
old: стары
on: на
one: адзін
only: толькі
open: адкрыты
or: ці
orange: аранжавы
oranges: апельсіны
other: іншы
others: іншыя
our: наш
outline: контур
over: над
paint: фарбаваць
painting: карціна
pajama: піжама
pajamas: піжамы
pan: патэльня
pancake: блін
paper: папера
pardon: прабачэнне
parent: бацька
park: парк
past: мінулае
path/way: шлях/дарога
peace: мір
peaceful: мірны
pear: груша
pears: грушы
pen: ручка
people: людзі
pepper: перац
perhaps: магчыма
person: чалавек
picture: карціна
pictures: карціны
piece: кавалак
pillow: падушка
pity: шкадаванне
pizza: піца
plan: план
plate: талерка
play: гуляць
playing: гуляе
plays: гуляе
pleasant: прыемны
please: калі ласка
plum: сліва
plums: слівы
point: пункт
poland: польшча
pole: паляк
policeman: паліцэйскі
portrait: партрэт
possible: магчымы
pot: гаршчок
prepare: рыхтаваць
preparing: рыхтуе
price: цана
proud: ганарлівы
proudly: ганарліва
put: класці
putting: кладзе
quick: хуткі
quickly: хутка
quiet: ціхі
radio: радыё
rain: дождж
raining: ідзе дождж
ran: бег
reaction: рэакцыя
read: чытаць
reading: чытае
ready: гатовы
receipt: квітанцыя
red: чырвоны
region: рэгіён
regions: рэгіёны
repeat: паўтараць
rest: адпачынак
restaurant: рэстаран
return: вяртаць
returns: вяртаецца
rich: багаты
right: правы
ripe: спелы
rise: падымацца
rises: падымаецца
river: рака
road: дарога
room: пакой
rose: ружа
ruble: рубель
rubles: рублі
run: бегаць
running: бяжыць
runs: бяжыць
russia: расія
russian: рускі
sad: сумны
sadly: сумна
sadness: смутак
salt: соль
saturday: субота
sausage: каўбаса
says: кажа
scarf: шалік
school: школа
sea: мора
season: сезон
seasons: сезоны
seat: сядзенне
second: другі
seconds: секунды
security: бяспека
see: бачыць
sees: бачыць
sell: прадаваць
seller: прадавец
sells: прадае
september: верасень
series: серыя
sets: усталёўвае
seven: сем
seventeen: семнаццаць
seventh: сёмы
seventy: семдзесят
sew: шыць
sewing: шыццё
shame: сорам
shape: форма
shapes: формы
sharp: востры
she: яна
shelf: паліца
shine: свяціць
shines: свеціць
shining: свеціць
shirt: кашуля
shoe: туфля
shoes: абутак
shop: магазін
shop/store: магазін
short: кароткі
shorter: карацейшы
shorts: шорты
show: паказваць
shows: паказвае
side: бок
sides: бакі
signed: падпісаны
silent: маўклівы
silver: срэбра
similar: падобны
simple: просты
sincere: шчыры
sing: спяваць
singing: спявае
sister: сястра
sit: сядзець
sitting: сядзіць
situation: сітуацыя
six: шэсць
sixteen: шаснаццаць
sixth: шосты
sixty: шэсцьдзесят
skin: скура
sky: неба
slav: славянін
slavic: славянскі
sleep: спаць
sleeps: спіць
small: маленькі
smart: разумны
smell: пах
smells: пахне
smooth: гладкі
snow: снег
so: так
sock: шкарпэтка
socks: шкарпэткі
soft: мяккі
sometimes: часам
son: сын
songs: песні
soon: хутка
soul: душа
sour: кіслы
south: поўдзень
southeast: паўднёвы ўсход
southern: паўднёвы
southwest: паўднёвы захад
speak: размаўляць
speaks: размаўляе
speed: хуткасць
spirit: дух
spoke: казаў
spoon: лыжка
sport: спорт
sports: спорт
spring: вясна
square: плошча
square/market: плошча/рынак
stable: стабільны
stadium: стадыён
stand: стаяць
standing: стаіць
stands: стаіць
star: зорка
stars: зоркі
station: станцыя
stays: застаецца
still: усё яшчэ
stomach: страўнік
stone: камень
stones: камяні
stops: спыняецца
straight: прамы
strawberries: клубніцы
strawberry: клубніца
street: вуліца
strong: моцны
stronger: мацнейшы
strongly: моцна
student: студэнт
students: студэнты
stupid: дурны
subject: прадмет
suffer: пакутаваць
sugar: цукар
summer: лета
sun: сонца
sunday: нядзеля
suns: сонца
sure: упэўнены
sweet: салодкі
swim: плаваць
swimming: плавае
symbol: сімвал
syr: сыр
t-shirt: футболка
table: стол
talk: размаўляць
talking: размаўляе
talks: размаўляе
tall: высокі
taller: вышэйшы
taller/higher: вышэйшы/вышэй
talt: тальт
tasty: смачны
tea: чай
teacher: настаўнік
tells: кажа
ten: дзесяць
tennis: тэніс
tenth: дзесяты
than: чым
thank: дзякаваць
thanks: дзякуй
that: што
the: a
their: іх
them: іх
then: тады
there: там
these: гэтыя
they: яны
thin: тонкі
thing: рэч
things: рэчы
think: думаць
thinner: танчэйшы
third: трэці
thirteen: трынаццаць
thirtieth: трыццаты
thirty: трыццаць
this: гэты
those: тыя
thousand: тысяча
thousandth: тысячны
three: тры
through: праз
thursday: чацвер
time: час
times: часы
tired: стомлены
to: да
today: сёння
tomorrow: заўтра
too: занадта
towards: да
traffic: рух
train: цягнік
trains: цягнікі
travel: падарожнічаць
travels: падарожнічае
tree: дрэва
trees: дрэвы
tremor: дрыжыкі
triangle: трохкутнік
troubling: трывожны
trousers: штаны
truth: праўда
try: спрабаваць
trying: спрабуе
tuesday: аўторак
twelfth: дванаццаты
twelve: дванаццаць
twenty: дваццаць
two: два
ugly: непрыгожы
uncle: дзядзька
under: пад
understand: разумець
underwear: бялізна
unit: адзінка
universe: сусвет
until: да
us: нас
vacation: адпачынак
valley: даліна
valuable: каштоўны
very: вельмі
vineyard: вінаграднік
vlad: улад
vodka: гарэлка
walk: хадзіць
walking: ходзіць
wall: сцяна
want: хацець
wardrobe: гардэроб
warm: цёплы
warms: грэе
was: быў
watch: глядзець
watching: глядзіць
water: вада
way: шлях
we: мы
weak: слабы
wear: насіць
wearing: носіць
wears: носіць
weather: надвор'е
wednesday: серада
week: тыдзень
weekend: выхадныя
welcome: сардэчна запрашаем
well: добра
went: пайшоў
went/walked: пайшоў/прайшоў
were: былі
west: захад
western: заходні
wet: вільготны
what: што
when: калі
where: дзе
which: які
white: белы
who: хто
wide: шырокі
wife: жонка
will: будзе
wind: вецер
window: акно
windows: вокны
wine: віно
winter: зіма
wise: мудры
wiser: мудрэйшы
with: з
within: у межах
without: без
wolf: воўк
woman: жанчына
women: жанчыны
wood: дрэва
words: словы
wore: насіў
work: праца
worker: рабочы
working: працуе
works: працуе
would: будзе
write: пісаць
writer: пісьменнік
writes: піша
writing: піша
year: год
year's: года
yellow: жоўты
yes: так
yesterday: учора
you: ты
young: малады
your: твой
zero: нуль